10 10
1 1 1 1 1 2 2 4 4 2
1 1 1 2 2 2 2 2 2 2
1 1 1 -5 2 2 2 2 2 2
1 1 1 1 1 2 13 4 4 2
1 1 1 2 2 2 4 1 1 4
1 1 1 1 2 2 4 1 4 2
1 1 1 2 2 2 2 4 2 2
1 1 1 2 2 2 2 2 2 2
1 1 1 1 2 2 10 2 14 2
1 1 1 1 1 2 2 14 2 2